%%%%%%%%%%%%%%%%%%%%
%   %    P     %   %
%   %          %   %
%%%%%          %%%%%
%                  %
% %              % %
% %  ..    ..... % %
% % ....   ..... % %
% %..  ..   ...  % %
% %......   ...  % %
% %..  ..   ...  % %
% %..  ..  ..... % %
% %..  ..  ..... % %
% %              % %
% %              % %
%                  %
%%%%%  %%%%%%  %%%%%
%   %  %%%%%%  %   %
%   %  %%%%%%  %   %
%%%%%%%%%%%%%%%%%%%%
