%%%%%%%%%%%%%%%%%%
%        P       %
%                %
%                %
%                %
%                %
%%%%%%%%%%%%%%%%%%
