%%%%%%%%%%%%%%%%%%%%%%%%%%%
%             P           %
%                         %
%%%%%%%%%%%%       %%%%%%%%
%                  %     .%
%                  %%%    %
%                  %%%%   %
%                  %% %   %
%                  %% %   %
%                  %% %   %
%                     %   %
%                     %%  %
%                      %  %
%                      %  %
%                      %  %
%                      %  %
%                      %  %
%                      %  %
%                      %  %
%                      %% %
%                       % %
%                       % %
%                       % %
%                       % %
%             %%%%%%%%%%% %
%                         %
%%%%%%%%%%%%%%%%%%%%%%%%%%%
