%%%%%%%%%%%%%%%%%%%%
%G                 %
%                  %
%    %        %    %
%   .%        %.   %
%%%%%%        %%%%%%
%..              ..%
%..              ..%
%..              ..%
%%%%%%        %%%%%%
%%%%%%    P   %%%%%%
%..              ..%
%..              ..%
%..              ..%
%%%%%%        %%%%%%
%   .%        %.   %
%    %        %    %
%                  %
%                 G%
%%%%%%%%%%%%%%%%%%%%
