%%%%%%%%%
%.  %  .%
%   %   %
%   %   %
%      G%
%G  %P  %
%   %   %
%.  %  .%
%%%%%%%%%
