%%%%%
%P  %
%   %
%   %
%%%%%
