%%%%%%%%%%
%   G    %
% %%%%%% %
%      % %
%      % %
%      % %
%      %%%
%       P%
%        %
%%%%%%%%%%
