%%%%%%%%%%%%%%%%%%%%
%                  %
%   %              %
%   %       %%%.%% %
%   %    ....... %%%
%   %    .......%%%%
%  %%% P%.......% %%
%  %%%%%%%.....  % %
%    %%%%%....%%%% %
% %% %%% ....% % %%%
% %%%% % ....  %   %
% %%%% % .. % %    %
% %%%%%% .. %%%... %
%    %  %...%% ....%
%    %  %  ..% ....%
%    %% %% %%  ....%
%     %% %%%%......%
%       %%%% ..... %
%                  %
%%%%%%%%%%%%%%%%%%%%
