%%%%%%%%%%%%%%%%%%%%
%                  %
%   %%             %
%   %      %%      %
%   %%     %%      %
%    %%%%%%%%      %
%                  %
%                  %
%                  %
%                  %
%                  %
%                  %
%                  %
%                  %
%          P       %
%                  %
%                  %
%                  %
%                  %
%%%%%%%%%%%%%%%%%%%%
