%%%%%%%%%%%%%%%
% .          .%
%..          .%
%.           .%
%.    % %    .%
%.    %.%     %
%.    % %     %
%.    % %    .%
%.    % %    .%
%..   %P%    .%
% .   % %    .%
% .   % %    .%
% .    G     .%
% .    G     .%
%%%%%%%%%%%%%%%
