%%%%%
%G%P%
%%%.%
%   %
%%%%%
