%%%%%
%G%P%
%%%.%
%  %%
%%%%%
